1111111
1PCE001
1000001
1111111