11111111111
10C00000001
1E0000P0001
100000000C1
10000000001
11111111111