1111111111
1C1E000001
11000C00P1
1111111111