111111111111
10C000000E01
1E1110P00001
10000000C001
10000C000001
111101110001
1C0000000001
111111111111