11111111111
10C00000001
1E1110P0001
10000000C01
11110111001
1C000000001
11111111111