11111111111111
10C00000000E01
1E1110P0000001
1000000N00C001
10000C00000001
11110111100001
1C000000000001
11111111111111