111111111111
10000C1000P1
1C1000000001
101C000000E1
111111111111